NO pic/eagle.xpm
        F 111,010,000

C 255,021,01
			   EA pic/blue_stone.xpm
   		 		WE pic/color_stone.xpm

SO pic/purple_stone.xpm



11111111111111111111111111
1100000000011000000000001
11011000001110000000000001111111
10N10000000000000000000011110001
111111111101100000111000001111111111111111
11000000000110000011101111111
11110111111111011100100100011
1111011111111101110101010001
1100000011010101110000010001
1000000000000000000000000001
100000000000000110101010001
1100000111010101111111110011
11110111 1110101 11111110001
11111111 1111111 11111111111