NO pic/eagle.xpm
        F 111,11,1

			   EA pic/blue_stone.xpm
C 1,1,1
   		 		WE pic/color_stone.xpm

SO pic/purple_stone.xpm



111111111111111111111111
1100000110000000000111111
101100010000000000000011111
111111111101100000111000001111111111111111
11000000000110000011101111111
11110111111111011100100100011
1111011111111101110101010001
1100000011010100110000W10001
1000000000000000000000000011
1000000000000001101010100011
1100000111010101111111110011
11110111 1110111 1111111001
11111111 1111111 11111111111