NO ./path_to_the_north_texture
        F 111,100,255

SO ./path_to_the_south_texture
			   EA ./path_to_the_east_texture
   		 		WE ./path_to_the_west_texture
C 999,001,01
//maybe implement limit on rgb of 255















11111111111111111111111111
10000000001100000000000011
101100000111000000000000111
10010000000000000000000011
1111111110110000011100000001
1000000000110000011101111111
1111011111111101110010010001
1111011111111101110101010001111111111111111111
1100000011010101110000010001
1000000000000000000000000001
10000000000000001101N1010001
1100000111010101111101110011
11110111 1110101 10111110001
11111111 1111111 11111111111