NO pic/eagle.xpm
        F 111,11,1

			   EA pic/blue_stone.xpm
C 1,1,1
   		 		WE pic/color_stone.xpm

SO pic/purple_stone.xpm



111111111111111111111111
11000001100000000001111111111111111111
1011000100000000000000111111111110111111
111111111101100000111000001111111111111111
11000000000110000011101111111
11110111111111011100100100011
111101111111110111010W010001
 110000001101010011000010001
 100000000000000000000000001 
 1000000000000001101010100011
1100000111010101111111110011
11101111111011111 111100111     
1111111111111111 111111111
