NO ./path_to_the_north_texture
        F 111,010,000

C 255,021,01
			   EA ./path_to_the_east_texture
   		 		WE ./path_to_the_west_texture

SO ./path_to_the_south_texture



11111111111111111111111111
10000000001100000000000011
101100000111000000000000111
10010000000000000000000011
1111111110110000011100000011
1000000000110000011101111111
11110111111111011100100100011111111111111111
1111011111111101110101010001111111111111111111
1100000011010101110000010001
1000000000000000000000000000
1000000000000001101N1010001
1100000111010101111111110011
11110111 1110101 11111110001
11111111 1111111 11111111111