NO pic/eagle.xpm
        F 111,11,1

			   EA pic/blue_stone.xpm
C 1,1,1
   		 		WE pic/color_stone.xpm

SO pic/purple_stone.xpm



11111111111111111111111
110000011000000000111111111111111111
101100010000010000000011111111110111111
111111111101100000111000001111111111111111
1100000000011000001110111111
11110111111111011100100100011
1111011111111101110100010001
 110000001101010011000100011
 100000000010W00000000000011
 100000000000001101010100011
1100000111010101111111110011
11101111111011111 111100111     
1111111111111111 111111111