1111111111
0111111111
1100100011
111  00111
1100N00011
1100001011
110010011
1111111111
1111111111