11111111111111
110010000000011
011111111100011
111  00000000011
1100N00011000011
1100001011000001
1100100110000010
11111111111111
1111111111111