111111
100101
10  01
110N1
111111