NO ./path_to_the_north_texture
        F 111,010,000

C 255,021,01
			   EA ./path_to_the_east_texture
   		 		WE ./path_to_the_west_texture

SO ./path_to_the_south_texture





11111
10N01
10011
1001
1001
1001
1001
1001
1001
1001
1001
1001
1001
1111