NO pic/eagle.xpm
        F 250,250,250

			   EA pic/blue_stone.xpm
C 1,1,1
   		 		WE pic/color_stone.xpm

SO pic/purple_stone.xpm





1111
10N1
1001
1001
1001
1111
