NO pic/grey_stone.xpm
        F 250,250,250

			   EA pic/blue_stone.xpm
C 1,1,1
   		 		WE pic/color_stone.xpm

SO pic/purple_stone.xpm





1111
10001
10011
100W1
10011
1111