NO pic/grey_stone.xpm

			   EA pic/blue_stone.xpm
C 0,0,0
   		 		WE pic/color_stone.xpm
        F 0,0,10
SO pic/purple_stone.xpm

11111111111111
110010000000011
 11111111100011
111  00000000011
1100N00011000011
1100001011000001
1100100110000010
11111111111111
1111111111111