NO pic/eagle.xpm
        F 250,250,250

			   EA pic/blue_stone.xpm
C 1,1,1
   		 		WE pic/color_stone.xpm

SO pic/purple_stone.xpm

111111111111111111111111111111111111111
111111111111111111111100000000000000001
1111111111111111111111000000000000E0001
111111111111111111111100000000000000001
111111111111111111111100000000000000001
111111111111111111111111111111111111111